********************
*                  *
* ** ********** ** *
* **            ** *
* *** ** ** ** *** *
*     **    **     *
* *** ** ** ** *** *
*        **        *
* *** ** ** ** *** *
*     **    **     *
* *** ** ** ** *** *
* **            ** *
* ** ********** ** *
*  P               *
********************