********************
*                  *
*                  *
*                  *
*     P            *
*                  *
*                  *
*                  *
*                  *
*                  *
*                  *
*                  *
*                  *
*                  *
********************